NO ./textures/temple.png
SO ./textures/temple.png
WE ./textures/temple.png
EA ./textures/temple.png

F 188, 184, 183
C 37, 33, 36

   11111111111111111
  1000000000000000001
 10000100000E000000001
10001001000000000000001
 100000000010000000001
  110000000000000000001
    111111111111111111