NO ./textures/temple.png
SO ./textures/temple.png
WE ./textures/temple.png
EA ./textures/temple.png

F 
C 

111111111111111111111111
100000000000000000000001
100000000000000000000001
1000000E0000010000000001
100000000000000000000001
111111111111111111111111
