11111111111
1000E000T01
11111111111