NO ./textures/temple.png
SO ./textures/temple.png
WE ./textures/temple.png
EA ./textures/temple.png

F 188, 184, 183
C 37, 33, 36

111111111111111111111111
100000000000000000000001
100000000000000000000001
1000000E0000010000000001
100000000000000000000001
111111111111111111111111
