                  NO ./textures/liu1.png
SO ./textures/liu2.png
WE ./textures/liu3.png
EA ./textures/liu5.png

F 188, 184, 183
C 37, 33, 36

        1111111111111111111111111
        1000000000110000000000001
        1011000001110000000000001
        1001000000000000000000001
11111111101100S001110000000000001
100000000011000001110111111111111
11110111111111011100000010001
11110111111111011101010010001
11000000110111011100000010001
10000000000000001100000010111
100000000000000011010100101  
110000011101010111110111101111
11110111 1110101 101111010001
11111111 1111111 111111111111



                   
