NO ./textures/dungeon.png
SO ./textures/dungeon.png
WE ./textures/dungeon.png
EA ./textures/dungeon.png

F 188, 184, 183
C 37, 33, 36

1111
1E01
10S1
1111
