NO ./textures/dungeon.png
SO ./textures/dungeon.png
WE ./textures/dungeon.png
EA ./textures/dungeon.png

F 188, 184, 183
C 37, 33, 36

111111111111111111111111
100000000000000000000000
100000000000000000000000
1000000E0000000000000000
100000000000000000000000
111111111111111111111111
